R 1920 1080

NO ./texture/north.xpm
SO ./texture/south.xpm
WE ./texture/west.xpm
EA ./texture/east.xpm

S ./texture/stop.xpm

C 56,34,12
F 111,111,111

         111111111111111111111111 
        1000000000110000000000001
        1011000001110000002000021
        1001000000000002000000021
111111111011000001110000002200001
100000000011000001110111111111111
11110111111111011100000010001
11110111111111011101010000001
11000000110101011100000010001
10002000000000001100000010001
10000000000W00001101010010001
1100000111010101111101111000111
11110111 1110101 101111010001
11111111 1111111 111111111111
