R 1920 1080
NO ./texture/north.xpm
SO ./texture/south.xpm
WE ./texture/west.xpm
EA ./texture/east.xpm
S ./texture/stop.xpm
F 220,100,0
C 225,30,0

1111111111111111111111111111111111111111111111111111111111111111111111111111111111111111111111111111
1200002000000000020020020000020000202000020000002020020200000220002202020200020000200000000020002201
1000002002000000020000200200222000200000202220000222000020000000000000000000000000000002000222200001
1020002020000020000200200000000000002000000202000002002000200000202000002020200000200002000002000001
1020000200220000000002220002000000202000020200022000220000002022020000002020000000000200022202022001
1000000000000002202220000020000000000000202002000000020002000000002200022000000000000200002000020001
1002000000002020002200000000000000000000000022020000002000200000202020002200020200000000000000000001
1002000202000000002020000000000202000002000000200000020000200000222020202020020020000002020000200001
1000000000000200000000000020020000002002000000000000000000020000200000000000000000000000000002002001
1000222000000000000200000002000000020000000000000000000020220000000020200000000202000000220002000001
1000200002020200200002000020220020202000200022202002000020000200000020000000000000020002000002000001
1020020200200000002000000020020020000200020200200000000200000200000000000000000002020000200000002021
1000000000200000002000000000002000000220020000020200000200020002000000200000020000020000200002002201
1202000000000000000020000220000000200000200000000000000002000020000002000202000200000002020000020001
1000000002000000000020200002022000022000000222020022200000200000000020000000002202200000000000002001
1000000020000000000000002000000022000000020020002000000000202000020000020200000002000000000000000021
1000000020200200200000002000002200020000000000000222200200000000000000000000002020200200000002000001
1002020202222200002020200020020000002020000000000000002000200000000020000000202020002022020000202001
1000002000000000000000002002200000000020002200000000022200000000200202200000002000000200002000002001
1000000000020000000000000002020020222000200220000022000000200202000000000002000000020200220020200001
1200200200000000000000200000000000200020000020000002000202000000200020220000000000000220000000000001
1000000000000000200000002200000000000220000002000000000200220020000200200000020000002020000000200201
1002000020000020200000002020000002220000220000000000200000202222002020000000202220000200200002000021
1200022020000002000000002000200000000002200222020000000000000000000000000020000000020022000200000021
1000002000000000000000020000020202002002000000002000000002000000002200020002200020000000000000002001
1020002000000220000000002000000000000002220200000000202000002020002020020000002020000000000000000201
1000200002000002020000000022000000000000000220002002020000000200002000000002200000002002022002000001
1000000002022020000000000200020000000200000000200002000020000020000200002202200000000002200020000001
1200002000200200002000000220200222000220000000000200220022000220200000000000200000220020000002000201
1020000000000000002000000200000000000000000000022000000000222200000002000000200000020002000002020001
1000000000002000002200020000000000202200002000020000020000020000220002000200200000000020000200000001
1000000000220002000000000202002000200000200002000020000020002022000000000020000000000200000002000001
1000000000200000002000020000020220000000202000000020020200000020220000000222000000022000000000002001
1020000000200002002000000000000000000000020000002002000200000002000002000000000000200000022000002001
1000202000000200202000220002000000020000002022000002002000000002000020000000020022000000000222000001
1200200002022200202000000000200002002000000000000000200020000000000000000200000000220200002000002021
1000200002020002020200000000000000000000000000200202000000000000000000000020020000220002000000000001
1020220000000000000000020000022020000200020000000002000000000020002202000000000000200000000000020001
1000200200000000000000000000022000000000002000200020020000202020200002000000002000000000002000000201
1222220000000020020200220000000002002020022000002000000000000020020020000200000002022000000020020021
1200000000002000200020000020020022000002000000000000200020002000000220000000000000020200000000200001
1002000002000000000020020000020000002200202022000000020000000020000000002200000002000220000000000001
1020022000220020200000020020020020000000000020000020200000000200002022020002000000200000020002000001
1002020002200000000200002000000000020200200000000000000020000000000000220000000000000200000000000021
1200002200000000000000000000000000002000000220000200000022000002220000202000000020000200002020002021
1000000000002200000200000000000020022000000000000000020020000000020000220002000020000002000000002001
1202002020000002200000000000020020020002002200000000000020000020000222000200022020220020000000002021
1000000000002000222200022220020000000200000200000000200000202000000020200000000000000000000000002001
1000000020200002000000220000000000000200000000020000020002020000020020002202000000020020200200002021
1000020000020020000000000222000002000000002000000000020000002200000200000000022202000002000000000021
10000000000200000200002000000220200022000000000200N0000020000002022020000000220002200000200000022001
1020002002000000000202000000000220020200002000000000002002000202200020220002000002020020000000020001
1000002000002000000000000000000202002000020000002020000002220000220022000000000000000002000022000021
1020000022000202000000200002000000020000000000200000200002000000200022000020000002020000200000000001
1000200000000002200020000000020000200002000000000000002020002002000002002020000200200020020000200021
1020000002022022000000000020020000000200000002020000200002000200000002002000000000002000020000002001
1000000200000000000200000000000000000000020000220020220000000002002200002200000000220020020220000001
1020002000000000020020020220000022220000000002000020002000200000000202020020020002000200002200000001
1000002000002220020000000000020000002000000000200000200200020000000200000000020022200000022020000221
1020022002000000000002200002020020000000000202000000200000000020000020000000202000000200000002002001
1000200000002000000200000000200020200200200022000020000000202000000002000002200002000000200000000221
1000000000002020002000200200000202000000202200000022000000000000220002000200000000002000022020200201
1002000200000000002000000002000000020002200000000000000000222000000002000000020220000002200000020201
1000200000000000000000022020000020000002002002000220000000000000022200200000200000000000000000000001
1000000000000200000202000020000000000020000000022202020020020000000000200000000000000020000002200001
1000000000000000200000020200200000200202000000000000220020020000020000000000220000002022220000020001
1000020000020000200002002000000022000000000000202000020000000200002202000000000002002000002002020201
1000222000000000200000000000000002020000022000020002000200020000000002020000020200000200200000020201
1000000000000020000000000000200000000000000020200000000000002202200000020200000002200020000200020021
1000000200000000002000002020000000000000022220000000200200000000220200000020000000002002000000000021
1200000200202002000002000000202000000200000000000002200200020200022000020020000000200000000000200001
1000220020000000000000200200000000002000020002002000200000200200000000000002202000020000002000200201
1020020020020000200002002022000200000000000200000000000000002000000000020020000000000002000022022021
1020002000202002000200000000000020200002020000020220000202002200000022000000222220002000200000002001
1000200020000002000022200200000222200202000000002200000000002020000220002002000020000002000202000001
1002002000200022000000020200200000220000200222000000020200000022000002200202022020000000002000000021
1000000000000020022002000000000000020200000000022200000002020000000000000000200000002022020000002001
1000000000200000000000000000000000000202000000000000020020000202020000200002000000000020000000000201
1000220020000020000000202000220022020200000000220002020200000000000000200000000000200220002000200201
1002000202202000222000000000000000000000200020002000020200000020000000000020000000000000002000202001
1200002002002000020000002220002000000000000000022020000020020002020002200000002000020002000000000001
1022000000002020000000000000200200002000000020200002200000000002002020202020000000200000000000000201
1002000000000020000000000222020000202020000000020022002022022000000220000200000200002000002002000001
1200000200000000022000020000022000000200222220020020020020200002000002000002200200000202200200000001
1000000020000220202000002002022000000000000000000020002000000020000000000000000000000200000002020201
1000000200000200200020000000202022200000000000200000000000000000020000000220000002000000000020000001
1020000020020000200000000202000000000000200000002000002000000000000020000000000000000000000000200001
1002200000000000002022000000022020000200000002220000000202020022200020020200000000000220002000200001
1000000000000022002002000000020000000002000200020000000000000002000020002002002000200002000000000001
1000000200200000002000000002000000000000000002200002002000002002000002000022002000200000022000000001
1000000020200000200000200020000002000000002022000000000000000002002000222202000000000200002020000001
1020002202000000200020000000002022200200000200000000202002000000000020000000000000000020002000002001
1002222000000000000000000000020002200200000000000000000200002022000002002002000020000222000002000001
1020000000002000000202000220200020020200020000000000000202000000200000200000000222000000000022000001
1200002000002000000000202000000200020202022000000000000000000002020000220002002000202000202020000001
1200000200000020000002002022200200000000020220020002200000000020002002000000020000200200200000000001
1000200200020000000220000220002000000200000000000000000220002020000202000202000000000000000000000001
1020000002000000022020000000000020000000000000022002200020022000000000220000000000000200000220000021
1000020220002022000000000000000000022200000000002000200002202000000000000000200000002000000000000001
1111111111111111111111111111111111111111111111111111111111111111111111111111111111111111111111111111