R 1920 1080
NO ./texture/north.xpm
SO ./texture/south.xpm
WE ./texture/west.xpm
EA ./texture/east.xpm
S ./texture/stop.xpm
F 220,100,0
C 225,30,0

11111111111111111111111111111111111111111111111111111111111111111111111111111111111111111111111111111111111111111111111111111111
10200000000000200020000002000000202000002000000020002000000000000002000000000000200002200020000000000000000000002002202002000001
10000020000000000000202000200020000202000200000020200000000002000200000020002000002000000200000000020220000000202200200000000001
10020020000000000000002000000000000020020002020200020000002000020000000000002000000002002000020000200200000200000020200020000021
12200000200000200000220200000000000000020000220000002020000000020000000200202000000000000220000020220200000002000202000000000001
10000000000020020000000200000000000000020000020200020200020000002200000000000000000000020200200200002000000000000000000200220001
10000020000200000200220000000000000002000000200020002000202000200000002020200200200202200000002000202002200000020222202002022001
10000220002022000002000002000222022202000220000000000202000000000002020000002020022002000002000022020000000000020022000000002201
10000020000020200020022000000000222200002020020000000002000200000000200020000002002000200002020200000000000000002020002200200221
10020000000000000000000000000000020000000022000000202002000000000220200000200220200202020220000000200200000002000000200000220001
10000000000002000020200022200200202000000000000202020000002000000202000200020000002000000020000000002020020202020000020020200021
10000200022000000000000000000200020200000022000000200202200200000000200200000002200222000002000000002200020200002202000022000001
10000220000022020202000020020000200020000020200002002022000000020000220020000000200000000000000000000000000200020000002022000021
10000000000000200020002000020000002000000000000000002200000000000202200002000020000000000000000002002000200000022000200000020001
10000200020020002000200000000000000002200000000000020200000002000000022200020002000200020200002000200020000002000000000000000001
10000000002200200000202000200200020000000000202220000020002000000000020000000000002002000000000002000000000000000220002002000201
12000020020002200000020000202000000000000002000000000020020000200022000000020200002002020002000000200000020000022000020000000021
10020020200222000000000020200200020000000002022220000000002000000000202000000000002000002202000020002020200200000020000000020021
10000000000002000000020000022000200222000000022000000000000000000020002002000000000000200002000002000000022020000200200020020001
12000200000222000020200000200000000000000000000000000020002000000020000000002200000020000002200220000020220000000000000000022001
10020000020000000020000000000000002000200200020200220000000000002000020202000002000200000200002000000000000022020002220000000001
12020220000020000000000000020000000200000002220000022000002000000020000200220002000020020000200220000000000020220000002000202201
10222000000202202020000002000200000200020000000200020000000000000000000000000020000000020022000000020000200000000020200000200021
10000000000000000200000000000000000000020000022000000000020000000000000020000020000020000000000000000000000000002220020002022021
10000002200002000000000200200220000002000200000200000020000000220002002020000000000000000200020200200000202020000000200000000201
10020002002020000200020000020000002000000020000000220002000020000002000000020000000000000020000000000000000000020200000000000001
12020000000000000002020020000000000200002002000200200000002000022220220000000000000200000000000000000000222020000000002020200001
10200002000020200000000000000022020000000000000000000000020000000000020020000000000000200000020000020000000000020000000002020001
10000022200200000020020000000000000000202000020202000202202020200000020000000022000000000222000000002020022200000020002000000001
10200020000020000000200020000000000000020002022000200002020000020002000000002000000200000000020000202000200020202200000002000001
12020002000200202002000020000000002000200002000002202000000020000200002000000000000020000000000222000000000000020200000000000001
10000022000000200020000000002000020000020000222002020200000000002220000000200002000000000000002000000000000000220000000200000001
10220020000022200000000000000000020200000020220200202020020020000202022000220002200000222200000220000002000020000002020000000001
10000000200000200000000200000000002000000020000000000220020200020002020222002000000002020202000000002020200002020220020000020001
12000200002002002222000202020202200000002000000200000020000000200000022000200202000000000200000000000020000000020000000000222001
10000000000202000000200000202002000002022000000000000000000020000000202000000200000000202020222200000200000000202020000000002201
10000000000220000020222200000000000002000000020000000002000000000200020200000220220200200002000200000222202000020200002202000021
10022200000200020200000002002200000000020200000000000000202000002002000000020200000000000000000000000000020022000000002200000001
10220000000200002000220202020000000000000000000020200000002000200000000202022000000000022002000002200000022000020000000020022021
12002000020200020200000000002020000020200000000200222000020000200002002000000020000000200020002000000000020000002000222202200021
10200020002020000000000000020000220002000000002020200002020002000000020000002000200200020200200000000200202000000020000020220001
10000000002000200020000020000000000202000002000000000220000002202200002020002000020000000000000000000002200000000000000002002001
10000222200000002002200202000002000220002020200000000200020000202020200000200000020002000222220020200000200000002002000220002201
12000000000000200000200000000000000200000220000000000000000000000000000202000000000000022002000200000200000020000200020000000001
10000022000200000020020000000000200000000000000002002200020200200000002022002022000000002002002000000220000020000000000020000201
12200002202020000000000200222022002000002002000000002022000020022002000200200000000220000000200000220000000000000020000000220021
12000020020000000002000200200000002020002200200020000000002020000020002202002000220020002000020000000000000200020000002000202001
10002200000200002020000220002200000000000202000000020000000000000222020022002222020000000020002000000220000020000002200020000201
12000002020020020000020000200220000002220000000002000000022000020020000200002000200020200000000000020000002220202000200000220021
10202200222000000000020000002000002000000002000020020000202000000000020000000000000000020002000002200002000000000000200020000021
10000002020000000000200000200000002200000000000000002220000200220000200000000020020200002000020020000202000002000002000200202001
12000002200000000002000200220000002200200000000000000000000020002000000200000000000020000000000200200200200000000000000200000001
10200000000000000002000002000020020020000000002000000000200020022000000022022002000200000000000002000000022000200200000020002001
10000000020002000000000000000000200000002000000202000200020000000220000000200000202000000000020000000000020200020200002000220001
12000000000000002022000002000220000200000020002000000020000000000200020002000000000000002202200000000000000000002002000002000001
10020020020002000200020202000000000000000020020000000000000020000200000000002220020000000200020000002000000000002022200002000021
10200000000000000020000000020200002000020020022000002220000002002000000200000022000000000020000000000020002000000000000002020001
10000202000000000000000002200002000020000200200000000202200000000200020022000000000002000002000020000020000002200000020000020001
10000002000000002002020000200000020200000002000000000000000000000002200202002020200200000000000222000022000020000022200202000201
10020000000200020002000000000002020022000002000000020200000000020000000000000200000020020200002200200000020000000000020200002001
10000000000000020000202200002000020000000000002000000000000000002000000000000000002020000000200200020020002000000200000000022201
10000000000020000000220000000000200220000002000000200200200002000000000020000000000000000000002020200000000000000000000020220001
12000002000002002000000000002000000002200200002000000222000002200000002000000000000000002000000200020200200000200000000000000001
10000022000000002200000200000200200000000000200000002020002000002020200200002000200000000000000000002022000000000000000200000001
1000000220000000200002002000000000000200220000000020222000220000N000000000000002000000002020200200000002220000220000000000000001
10200020000000020000202200002000000000000000000002000000000200002000000220000020000000000022002000200020000022000000000000000201
10200202220000000000202000200000000000202022200002000002020000020000000000000202200000020000000020020000220002200000000000200201
10022200000000000020200000000200000002000000002000202200020002002002200020000020000000002020200000020000002200000000020020000021
10002000000000000000002000000022000000202000000200222000220202000200000000020200202222000002000200000020222222000000000022020021
10000000000200000202000002022000020000200000000000022000000200000002002200022220000200200000202000000000000000000000200002002201
10000200000000020000200202000000202200002020000000000000000002000020000222220202020000000000000020200000000022000000000000020001
12000002000000000000000002000000002200020000000020000000000002022020000000000000020000000002020200000000200000020000000000002001
10000200200220000000200000000000200022000000200000020220000000000000200020200202000202000002000000000000000000202000200000000001
10002200200020000002020000020000002020000000200000020002022000020002000000200002000002000002002000000000000022000022200002002001
10000000002002000000000000000000002202000000020200200000200000000020000000022000000000002000220200200000000000000000000002020001
12000020000000200000020020000000000000000200000200000000000000220000020020200000022000000200000000002000000000020020200000200001
10020002202200000000000020022000000000000002000000000000002220020000000222020200000000002000000200000000020220002000200000200021
10000000000000000000020220000000202000000202200000000000020000000000000000000000002200000200000000020002002020000200000020200001
12000000020000200000002202200000002202002000020000000200000002002000000000020000000002000220000220200000020000200020020002020021
12002020000220020022000020022020000002202000020000022000000002020000020020022002202000000200200020002000002020002000020000002001
10022200000000000000020200000020000000000000000220220000000200000000200200000020000000200000000000000000000002000200200200200001
12000000000000000000000000020002000000000202000000000002000202000000020022000002000000200202000020000002000000200200002020020221
10000000022000000000220000022200220000220000000200002020002000000000000020200000002000000000200000000200000002002002000200000221
10000000000020000022002000000200000220000000200000020000202000020002202200000002000002020020000000000020002000000000000220000001
12000022200200022002000000020000200020000002002020000202222000020000000000000000002002020000000000220020020200220020000000002021
10200020202200000000000000000020202000200000000000002002002200020202000000000000000000002000000202000000000000220000000000022001
10200220200002000000200000000022000000022022000002020000000000000020002000022000200000000020000200220000000002000000020220200221
10000002000202000000000020022000002000000220020000000000000000000000000000020000002002000222000020000200020202002020000000000201
10000020002022000000000000002000002200000200200002000000002022000002200022000000000000000000020022200000020000200000000020000001
10000000000220000000000000000000200000200000200002000000000200000000020000200000020000020002002000000000020220020000200020002001
12000020000000000002002002020022000000022002020020000020000002020200002002000020000000000000000000000022000000000002002000000001
10022000000200220002000000020200202200200020002000000000220202200200000000022000200000002020002000000000200002000200002020020001
12220000002200000022200000020002200000200000020202200000000000000000020000000002202202000000002020000002002200020002000000202201
10200002200020200200000000000000000200000200000000000000020020000002002000200000000220000000202000002202000002200002000200220201
10200200000200022020200200000000002000000000200202022000200002000002200000002220200000000002000000000200022000000200022000002021
12000000200000000000000000000000000020000000000000020020000000002002020000200000000000002002000220002000002000000002000000220001
10202000000000000000000000000000000000000000000000000020200000000200000000002000000000200200000202002000020002000000000020202021
10020000020000200000002020000200000000002002000000000002000000200000202002000220202000022200000000000000002002000220000000200001
10002002000200000202022000000200020020200020000000000000200020000000200200020000000020002002200000000000000000000000020000002001
10220020020000020000020020220000000022200220020000000000020022002000000000000000000000200020022000200202000020020000202002000001
10000000000000200000000200002000000220200000002020202000002000022000000200020222000202000000200200020000200000202000000000200001
10000200000200200000000200002020000000020002000000000000000000000000022000000000000000200000000200002002000000000000200000000021
12002200000020000000200222000020000202200020000020020000002000022000000000020202000000002002000022002200020020000002200200020001
10000202000000020000000000000000020000200220000000000000000002020000020002020000020000000000000000000000200020002000000200000001
10000220000020002020200000002200000222000002000020000220002000000000000002202020000000200000000220000002022000000000000000000001
12000000220000002000220020000000202000000020000200000002000002000022020020222000020000200000000000000020000022000000000200000001
10002002000020002200002002020220202000000000220020020002000200020000020002202002000000000200202002000000002200200000000000000021
10000000000222020002202000000200000000000000200202020000000000000000000002020020000000000002022000020002020002000020020000020001
10200202000000000000002000000000000020000000000002020020020200000000000000022202200000000000000020000000000000002000002020000201
12000020000000200000020000000000200000000020000000000000000000220002020000000000000020000000000002000000000022000022200000000001
10022000000002000200200000002000000000000000000200002000000200200002000020000000000000000220200000000202000020002000000200200001
10200000000202222000000000000000200000000000000002200000020000000000020000000020000000000002200000002202002000002020000200200021
12020000002200000000020000000020000200200002000000002020200020000000000000002002002000000200000000000020220002020220000000220021
10000202002000020022000022020000002002000200022000000220000000000200020222000200020000000002200000000000000200000200000200200001
12000020022000020000000000002022000000200020000020020000002220000000020002000000000000200202202200000000200002002000000000200001
12002000000020000000000200000002002000000020202000000000220000002022000022000220200000000000200020220002000000020020220000000001
10002000000200202200000002000020000200000220000000000000000200000000000222000000000020020000022000202002000002000000000200000001
10200020000000000200000020000200000200020002002000200000000000000020000200002000020000000000200200000002000020000200000000000001
10202000000002000002200000000000020000220000200020200002000002020000020000020222000200002000020000202000220202020000000002020021
10020000202000020000000020000200000020000000000020000000020000200002220000200220202000200000000000022020000000002020200200000021
10000000202200000000202002002200000022202000202022200000000020000200000002000020020002000000000000202000002000020000000022202001
10000000002000200200000002000000000020200000000000000000200022000020200000020202000002000220000000020000000020020000000002000021
10200002200220000020000220022200000002000000000000000000000000022022220002000000020000002000202020000002002002002000020000000001
10220220002000000000000020000220002000000000000000020000200220022000000000022000000000000002000000000220000020000002000000000001
10000002200000000022000202000020200000000000002000002200020000200000002022000000200000000220000000000002020000000020200000002001
10000000200000200000200002000200000200000002000200002002000000020000000020000000000000222200000000200000020002002000200200200201
12002000020002000200000000000000002200200200000000000002022002200000020020002200200000000002222000000022000002000000000200022001
11111111111111111111111111111111111111111111111111111111111111111111111111111111111111111111111111111111111111111111111111111111