R 1920 1080
NO ./texture/north.xpm
SO ./texture/south.xpm
WE ./texture/west.xpm
EA ./texture/east.xpm
S ./texture/stop.xpm
F 220,100,0
C 225,30,0

1111111111111111
1000000000000001
1002200020200201
1000000000000001
1000000202000001
1000000000000001
1000000000200001
1000000000000001
10200000N0000001
1000200000002001
1000000020002001
1000000000000021
1000000000000001
1002000000000001
1000022220002001
1111111111111111
