R 1920 1080
NO ./texture/north.xpm
SO ./texture/south.xpm
WE ./texture/west.xpm
EA ./texture/east.xpm
S ./texture/stop.xpm
F 220,100,0
C 225,30,0

1111111111111111111111111111111111111111111111111111111111111111
1000000020200000020022200000020000020000000000202000020000000201
1000000020000200000000000000020002200000000202000002200000000001
1000000000000000000002200000002000000000000002000020000000000021
1000000002020000002020220000000000000200002020000000000000000001
1000000000000000000022002000000020000000002000000200200000202001
1000000000000200000020000000002202222000020000200020000020200001
1002002000000000000020000000200000000000000000000000000000000001
1002020000000020000000200020000002020000000220000002200000200021
1000000220000020020200000000000000000000000200020000020000200001
1020000022000002002000002000000002000000002200000000020022000001
1200000020000000002002002200002000020020000200000200000020002001
1020000000000000000020200000000200000200000020200220020002020001
1200200000000002000000000000202202000220000000002000202002200001
1002002000000000000000000220000000000202200002020002000220000001
1020000020002000200000020000000000000200002200020000000200002001
1200002020002020020000000000000002002200020002000220000000020021
1002020000000000000002000000000020000000002020000002000002000001
1000000200000000000002002000000022022020002002000002002000000001
1000202200000000220200220000020022002020020000020000000000000201
1020000020000000000020020000020000200000002000000000000002000021
1002020200000000000000000200000020002200000000000000000000000001
1000000000200000000002000000000000200220000000002000200000000021
1200000200000000000000000020020020002222020000000000002000000201
1002200000022200202020020000000020000002202202000000000202000001
1000000000200000022000020000000000020002000000200000000022200021
1002020000000000002000020020200000000000202000222002000000000001
1002020000000222002000002200020000000002000000000002000020200001
1200020000000020000000000000000202000000002000000002200002000001
1000022000000020002020000200020002000000020000000020000000002021
1000002020000200000020000200000020022002200000020000200020000021
1022200000000000000200200000000022000000222020000000200022000221
10020002002200022022000020002000N0000000000002000200000020002001
1200000000000000200200000000022020000000020000000002000000022001
1002002000020200020000000000002002002200000020020000000002000221
1000000000022000000000200000200002000000000200020000202000200001
1000000202000000020000200200002022220200000020220000000002020001
1000000200000200000000020000000000000000020000000000000000000001
1020200002002020002000000000022000020020202000202000200000200001
1002002002200000200000000020000020020002000000000000002020200201
1000000000022022200000202220002000000000000002020202020000020001
1220000020000000002200000200000000000000020000220000000000000001
1002000200000000002000000000020220200000000020000220000020000021
1000000200000000020000202000220000000222000002202000000002000021
1000002220000000200000200020220000000000002000000020020200000201
1000020020000000000000000200220200000020200202002000020000000001
1020000200020000000200002200000000000200020000000000000000000201
1002202000000000000000000220000020000200200000000000000200000001
1220000000200000000200000020000000020000000020200000000000020001
1000002202200002002202000000020200002000000200000000200020202021
1000000022020200000002020000000202000202200202000020000000200021
1000000000022022220000020000000000020000000002002000002002020001
1020000020002000020002200022000002000000000220000200200000200001
1022020200022202002000000000000000000200002200000200000200200001
1000000022002000000220000000002020000000020000020000000020020201
1220200002000000000002022020000000200020000020020000000020220001
1202000000000020002002200020200000000000200000200020020000222001
1000000020000202020000022000000000000000200000202000000000220001
1002000000000020020002000020000000000022000022000200000000000021
1000200000020222002020220022000022020020020000000200000000200201
1000000200000000200000000020000202000200000000000002022022000001
1200000002002220000200020000200002200200220000002000000000020201
1020000000000000000000000000000200002000000022000002000002000001
1111111111111111111111111111111111111111111111111111111111111111