R 1920 1080
NO ./texture/north.xpm
SO ./texture/south.xpm
WE ./texture/west.xpm
EA ./texture/east.xpm
S ./texture/stop.xpm
F 220,100,0
C 225,30,0

11111111111111111111111111111111111111111111111111111111111111111
10002000020020000002000002020022000200000000000000000020000000001
10200000020220200002200000000022000220002000200020000000200000221
10020000000220000002000000000000000000000022000000002000220200001
10200002002000000200022000000000000000000000200220000000022202001
12000200020000000000202200000000020000002002000000200000000000001
10000000020002000020000220022002002000200002000000000000000020001
10002002000000020002000000000000002000000200000200020000000000201
10000000000020020002000002000000000000002000200020020220000000001
10200000000002200000000002000000020000222020000020200200000002021
10000000000000000020220002200200000000000020020000000000000000001
12000020020000000002000020202002002000000020200220022000000020001
10000000000200200020200200000202000020000000220000022000000002021
10002002000000020002200202000000000020000202000020220000020002021
10000000020000000000000000002202000000020000002000002200000000221
10000000000202022000000200002000020200000000022000022002020000001
12020002002000202200000000002000200000000000000022200022200222201
12000000002002000000000000000000000022000020022000202000200000001
10000020002000000020200020000020202000000000002022002020200000021
10000000000000000000000002020020000220000000002220020000200020021
10000000000000002000000000000020002000000020000202200000000000001
10020000000000000002202000020020002002000000000022000000000022001
12000200000020200202002002000002000000000200220000020020000000001
10200002000000000000000020002000200002020000022020000020220000001
10200000000000002200000000002000000000202000022000200002200000021
10202200002000000020000002000020022020200200200000000000000000001
12220022020000000002200200000020000022000002002020020020000000001
10000000020202000000000000000200020000000020000000000002202002001
10000000000000020000000000200200000000000020000000202002000002001
10200220000002000200200002020000002202000000022020000020000000001
10020200020000000020000000000200220222002000022000200000202000001
10000000000000000000022000000000022000000002002000000000000000001
10000000000000000002020002000000N02202002020000000000000002000001
10000020022000000000020000000020220020000000000000000000202200001
10020000200200000000020002020000000200022020000000000020200020001
10202000000222020000000200000000220000000000020002020000000000001
10000000002000020000200002000000000022022000000222022000000000001
10022200000200000000020202022200220020000000000020202000000022001
10020000000000020000000000200002220000000000000000000000200000001
10200000000200220020000000000000000020200020020000020020020000001
12000202000000020000000000200200002000000000002000000020000002001
10202000000022000200000000000000002020200002200020000000000000021
10222020200020000202220000000200000002020200002000020000002200201
12002200002000002200000000000000222022000000000020000200202002001
12000022000000200022002000000020200020000000000020000020000220001
10002002000000002002000020000000200002020000200000000022020000201
12000000000022020000022020000200220000000000000020002000000000021
10000020000020000000000020200002002000200000220020202020000000201
10002002022000000002000000020020002000000022000000000000200000001
10000200020000000022020000002000200000000000000020002020000000021
10002200200000000000000022000000002000000002222000002220000000001
10002200220000000202020002002020200000000200020002000000000202001
10000020000000002000000000000000000200200000020000000000000022021
10020002000000002000000000000000000200220020000002000002000000001
12000020000000000000000002002000000200020002000002220000020202001
10020000000000022002200220000002002000000000002000000002200000001
10000000002000020200200200002002002000000000200022000000000000001
12000020000020022000000020000000000000000020020000200022000200001
10002000000000000000000200020020000000200000020000022000002020001
10000002000020200020000000000000020220200220000020200002002000201
10002000022000200002020020000000202000000000000000020000202000001
10200002000200000000002000020020002000020020000020020202002000001
10000002020220002002000000020000222000000000002000000002002000021
12000000000000000002000000020000200020200020000000000000000000201
11111111111111111111111111111111111111111111111111111111111111111